<!DOCTYPE HTML PUBLIC "-//W3C//DTD HTML 4.01 Transitional//EN" "http://www.w3.org/TR/html4/loose.dtd">
 <html>
  <head>
   <meta content="text/html; charset=utf-8" http-equiv="Content-Type"/>
   <meta content="user-scalable=0,width=device-width,initial-scale=1,maximum-scale=1" name="viewport"/>
   <link href="/sites/images/favicon.ico" rel="shortcut icon"/>
   <title>
    Barrie Skating Club :: Home Page
   </title>
   <meta content="BSC...providing quality skating programs from learn-to-skate to competitive for children and adults in Barrie and beyond for over 60 years." name="description"/>
   <meta content="skating, learn to skate, CanSkate, STARSkate, Competitive Skate, skating lessons, skating Barrie, Mariposa, " name="keywords"/>
   <!--[if lte IE 8]>
 <link rel="stylesheet" type="text/css" href="/css/ie.css" />
 <![endif]-->
   <link href="/css/overcast/jquery-ui-1.10.3.custom.min.css?1509648422" rel="stylesheet" type="text/css"/>
   <link href="/css/jquery.multiselect.css?1509648422" rel="stylesheet" type="text/css"/>
   <link href="/css/tooltipster.css?1509648422" rel="stylesheet" type="text/css"/>
   <link href="/css/themes/tooltipster-shadow.css?1509648422" rel="stylesheet" type="text/css"/>
   <link href="/css/introjs.min.css?1509648422" rel="stylesheet" type="text/css"/>
   <link href="/css/ui.css?1532596118" rel="stylesheet" type="text/css"/>
   <link href="/css/multi.min.css?1509648422" rel="stylesheet" type="text/css"/>
   <link href="/js/fancybox/jquery.fancybox-1.3.4.css?1509648422" rel="stylesheet" type="text/css"/>
   <link href="/js/selectize/css/selectize.css?1509648422" rel="stylesheet" type="text/css"/>
   <link href="/css/selectize-disable.css?1527192692" rel="stylesheet" type="text/css"/>
   <link href="/themes/_skatecanada/css/theme.css?1509648422" rel="stylesheet" type="text/css"/>
   <link href="/sites/css/site.css?1450917442" rel="stylesheet" type="text/css"/>
   <script>
    var jsmsgErrorEncountered = 'You have encountered the following error(s) on this page';
 	var jsmsgErrorsOccurred = 'The following errors have occurred:';
 	var jsmsgErrorSkuRequired = 'Sku is a required field.';
 	var jsmsgErrorTotalRequired = 'Total is a required field.';
 	var jsmsgErrorTotalInvalid = 'Total provided is not valid.';
 	var jsmsgErrorSummaryRequired = 'Summary is a required field';
 	var jsmsgErrorDescriptionRequired = 'Description is a required field';
 	var jsmsgErrorDescriptionNeeded = 'You need to enter a description.';
 	var jsmsgErrorPriceNeeded = 'You need to enter a price.';
 	var jsmsgErrorInstallmentInvalid = 'Invalid installments provided.';
 	var jsmsgErrorInstallmentRequired = 'An installment interval is required.';
 	var jsmsgErrorInstallmentPeriodRequired = 'An installment period (number of days, weeks, months between payments) is required.';
 	var jsmsgErrorInstallmentStartRequired = 'Installment start date is required.';
 	var jsmsgErrorEffectiveDates = 'You must provide a valid effective duration.';
 	var jsmsgErrorEffectiveSCSeason = 'You must provide a Skate Canada season.';
 	var jsmsgErrorStartDateInvalid = 'The effective start date is not a valid date.';
 	var jsmsgErrorEndDateInvalid = 'The effective end date is not a valid date.';
 	var jsmsgErrorRangeInvalid = 'The start date and end date provided do not make a valid date range.';
 	var jsmsgErrorDurationInvalid = 'The duration that you have provided is not valid.';
 	var jsmsgErrorQtyTotalInvalid = 'The Total Quantity Available must be an integer greater than 0.';
 	var jsmsgErrorAmountZero = 'You need to enter an amount greater than 0.';
 	var jsmsgErrorAmount1Million = 'You need to enter an amount less than 1,000,000.';
 	var jsmsgErrorDateInvalid = 'You need to enter a valid date.';
 	var jsmsgErrorCoachDirection = 'Unable to determine what direction to move the coach.';
 	var jsmsgErrorCoachWhich = 'Unable to determine which coach to move.';
 	var jsmsgErrorCoachUnknown = 'An unknown error has occurred trying to update the coach order.';
 	var jsmsgErrorUnknownTryAgain = 'An error has occurred. Please try again later.';
 	var jsmsgError = 'An error has occurred.';
 	var jsmsgErrorUnknown = 'An unknown error has occurred.';
 	var jsmsgErrorUnexpected = 'An unexpected error has occurred, if the problem continues please contact a system administrator.';
 	var jsmsgErrorUnknownShort = 'Unknown error';
 	var jsmsgErrorFindTarget = 'Unable to find target.';
 	var jsmsgErrorAttachments = 'You can only add up to 3 attachments!';
 	var jsmsgErrorGroupNameBlank = 'A group name cannot be blank';
 	var jsmsgErrorGoalMultiple = 'The same goal cannot appear more than once in an evaluation.';
 	var jsmsgErrorGoalGroupEmpty = 'You may not save Goal Groups without goals attached. Please remove them or add goals to them.';
 	var jsmsgErrorGradesZero = 'You cannot have zero grades';
 	var jsmsgErrorRetrieveSubscription = 'An error occurred trying to retrieve the subscription information. Please try again later.';
 	var jsmsgErrorNoDescriptions = 'No description available for this permission';
 	var jsmsgErrorFieldEmpty = 'Field cannot be left empty.';
 	var jsmsgErrorRealValue = 'The real value to map from is required.';
 	var jsmsgErrorNormalValue = 'The normal value to map to is required.';
 	var jsmsgErrorConditionNumeric = 'Condition should be valid numeric value.';
 	var jsmsgErrorConditionDate = 'Condition should be a valid date.';
 	var jsmsgErrorConditionEmpy = 'Condition should not be empty.';
 	var jsmsgErrorInvalidImage = 'You have not selected a valid image file.';
 	var jsmsgErrorSaveErrors = 'You may not save your changes while there are still errors.';
 	var jsmsgErrorReadPolicies = 'You must read all policies and agree to all the required policies before paying.';
 	var jsmsgErrorInvalidTotal = 'Invalid item total';
 	var jsmsgErrorInvalidDiscount = 'Invalid order discount';
 	var jsmsgErrorInvalidShipping = 'Invalid order shipping';
 	var jsmsgErrorInvalidTax = 'Invalid tax value';
 	var jsmsgErrorCardDetails = 'requires card details';
 	var jsmsgErrorOverdueMessage = 'An unknown error has occurred, please check your email to confirm if the messages have been sent and contact an administrator if this persists.';
 	var jsmsgErrorBatchEdit = 'The programs were not saved. Correct any fields with highlighted errors and try again.';
 	var jsmsgCannotUndo = 'These changes cannot be undone!';
 	var jsmsgErrorDuplicateTaxCode = 'You are attempting to add a tax code that already exists for this item. You must remove the existing one before adding this.'
 	var jsmsgErrorInvalidDate = 'Invalid Date.'
 	var jsmsgErrorErrorCheckingDate = 'Error when checking date.'
 	var jsmsgOrderAlreadyExpired = "Sorry, this invoice has already expired.";
 
 	var jsmsgConfirmReportDelete = 'Are you sure you want to delete this report?';
 	var jsmsgSuccessReportSaved = 'Report saved successfully.';
 	var jsmsgSuccessPaymentTransaction = 'Payment transaction successfully updated!';
 
 	var jsmsgConfirmBatchPaymentUpdate = 'Are you sure you want to update these payments to status ';
 	var jsmsgConfirmLeavePaymentBatchPage = 'Are you sure you would like to leave this page before saving your payment batch?';
 	var jsmsgConfirmCloseNoSave = 'Are you sure you want to close without saving?';
 	var jsmsgConfirmRemoveCategory = 'Are you sure you want to remove this category? This action cannot be undone. ';
 	var jsmsgConfirmRemoveCategoryLevel = 'Are you sure you want to remove this category level? This action cannot be undone. ';
 	var jsmsgConfirmRemoveRequirementGroup = 'Are you sure you want to remove this requirement group? This action cannot be undone. ';
 	var jsmsgConfirmRemoveRequirement = 'Are you sure you want to remove this requirement? This action cannot be undone. ';
 	var jsmsgConfirmRemoveAchievement = 'Are you sure you want to delete this achievement? Doing so may disqualify this participant from particular categories.';
 	var jsmsgConfirmDeleteAchievement = 'Are you sure you want to delete this achievement?';
 	var jsmsgConfirmImportAchievements = 'Import any Skate Canada Achievements not already listed in your achievements? Note, if you have renamed any previously imported Skate Canada Achievements, they will be re-added as new achievements.';
 	var jsmsgConfirmRemoveFromWaitlist = 'Are you sure you want to remove this participant from the waitlist?';
 	var jsmsgConfirmRemoveDomain = 'Are you sure you would like to remove this domain?';
 	var jsmsgConfirmDeleteParticipantValue = 'Are you sure you want to delete this participant value?';
 	var jsmsgConfirmSaveForm = 'Are you sure you want to save this form? Your changes will take effect immediately.';
 	var jsmsgConfirmDeleteTicketAuth = 'Are you sure you want to delete this device authorization?';
 	var jsmsgConfirmRecreateClassSched = 'Would you like to also recreate your class schedule? Changing the class times and locations will lose any previously recorded attendance, evaluations or attached volunteer positions.';
 	var jsmsgConfirmUpdateProductTaxes = 'Do you want to update your taxes to reflect the defaults for products?';
 	var jsmsgConfirmUpdateSubscriptionTaxes = 'Do you want to update your taxes to reflect the defaults for subscriptions?';
 	var jsmsgConfirmSendAllOverdueMessages = 'Are you sure you want to send a message to ALL MEMBERS that have an overdue payment, as specified in the global settings? Any selected filters will be ignored.';
 	var jsmsgConfirmSendOverdueMessage = 'Are you sure you want to send the overdue payment notification to this member, as specified in the global settings?';
 	var jsmsgConfirmMarkAsRegistered = 'Are you sure you want to mark this season registration as processed?';
 	var jsmsgConfirmDeleteSkateCanadaDetails = 'Are you sure you want to delete the connection between this participant and Skate Canada?';
 	var jsmsgConfirmDeleteSiteFieldValue = 'Are you sure you would like to delete the value for this custom field? All data will be lost and unrecoverable.';
 
 	var jsmsgConfirmRemoveRegistration = 'Are you sure that you want to remove this registration?';
 	var jsmsgConfirmRemoveProduct = 'Are you sure that you want to remove this product?';
 	var jsmsgConfirmRemoveSubscription = 'Are you sure that you want to remove this subscription?';
 
 	var jsmsgConfirmRemoveVolunteerPosition = 'Are you sure that you want to remove this volunteer position?';
 	var jsmsgConfirmSendEmailShared = 'Are you sure you would like to send an email with this report\'s URL to: ';
 	var jsmsgConfirmExpiringOrder = "This invoice will expire within 5 minutes and changes will be lost. Click OK to extend your time. Or click Cancel to continue editing. ";
 	var jsmsgConfirmPublishReceipts = "Are you sure you would like to publish these receipts? The receipts will no longer be editable after they have been published and users will be able to view them when logged in.";
 	var jsmsgConfirmAddNotHasRequiredGoals = "There are required goals for this achievement that have not been completed. Add this achievement anyway?";
 	var jsmsgConfirmAddNotHasRequiredCount = "The required number of goals for this achievement have not been completed. Add this achievement anyway?";
 	var jsmsgConfirmApproveNotHasRequiredGoals = "Not all required goals for this achievement have been completed. Are you sure you would like to approve this achievement?";
 	var jsmsgConfirmApproveNotHasRequiredCount = "The required number of goals for this achievement has not yet been met. Are you sure you would like to approve this achievement?";
 
 	var jsmsgConfirmDeleteSiteFieldValues = "Are you sure you would like to delete all values assigned to this custom field? All data will be lost and unrecoverable.";
 
 	var jsmsgNoticeNoResults = "There were no results found for your search criteria.";
 	var jsmsgNoticeNoPrograms = "No programs selected to be updated or created.";
 	var jsmsgNoticeNoChanges = "There are no changes to be saved.";
 
 	var jsmsgLabelPaid = 'PAID';
 	var jsmsgLabelOverPaid = 'OVER PAYMENT';
 	var jsmsgLabelPartialPaid = 'PARTIAL PAYMENT';
 	var jsmsgLabelUnPaid = 'UNPAID';
 	var jsmsgLabelUnbalanced = 'UNBALANCED';
 	var jsmsgLabelNone = 'None';
 	var jsmsgLabelHideWithdrawn = 'Hide Withdrawn';
 	var jsmsgLabelShowWithdrawn = 'Show Withdrawn';
 	var jsmsgLabelDisplayView = 'Display View';
 	var jsmsgLabelDeclined = 'declined';
 	var jsmsgLabelMarkCompleted = 'Mark as completed';
 	var jsmsgLabelMarkCompletedFirst = 'Mark as completed (Choose member first)';
 
 	var jsmsgTitleSetTrackPassed = 'Set all goals in this group to Track Passed Only';
 	var jsmsgTitleSetGoalsRequired = 'Set all goals in this group to Required';
 
 	var jsmsgPropAddAchievement = 'Add Achievement';
 	var jsmsgPropDeleteAchievement = 'Delete Achievement';
 	var jsmsgPropCompleteAchievement = 'Mark Achievement as Completed';
 	var jsmsgPropDeleteAchievementRecord = 'Delete Achievement from Participant Record';
 	var jsmsgPropTools = 'Tools';
 	var jsmsgPropRemovePrerequisite = 'Remove Prerequisite';
 	var jsmsgPropRemove = 'Remove';
 
 	var jsmsgSelectSkateCanadaContact = 'You must select a Skate Canada contact before saving.';
 
 	var jsmsgAddAchievement = 'Add an achievement';
 	var jsmsgAddCategoryLevel = 'Add a category level';
 	var jsmsgAddTag = 'Add a tag';
 	var jsmsgNoMatch = 'no matches found';
 	var jsmsgDays = 'days';
 	var jsmsgDay = 'day';
 
 	var jsmsgUpdate = 'Update';
 	var jsmsgAppend = 'Append';
 	var jsmsgSearch = 'Search';
 	var jsmsgReplace = 'Replace';
 
 	var jsFilterTableLabel = 'Quick Search: ';
 
 	var jsMaxFileSizeExceeded = 'Selected file size exceeds the maximum of ';
 
 	var jsmsgProgramStatusPublic = 'Publicly available.';
 	var jsmsgProgramStatusBeta = 'Beta or not yet registering.';
 	var jsmsgProgramStatusUnavailable = 'Not available.';
 
 	var jsmsgErrorQtyProductRequired = 'Quantity must be an integer greater than 0.';
 
 	var jsmsgEvaluationBlock = 'The Attendance for this event has not been taken or has been updated';
 
 	var jsmsgEvaluationDelete = 'Are you sure you would like to delete this evaluation?';
 	var jsmsgGoalDelete = 'Are you sure you would like to delete this goal?';
 	var jsmsgGiftCertificateDelete = 'Are you sure you would like to delete this gift certificate?';
 	var jsmsgPostDelete = 'Are you sure you would like to delete this post?';
 	var jsmsgVolunteerRequirementDelete = 'Are you sure you would like to delete this volunteer requirement?';
 
 	var jsmsgNoResults = 'There were no results found for your search criteria.';
 	var jsmsgErrorTryAgain = 'An Error has occurred, please try again.';
 
 	var jsmsgOpenPrograms = 'Open Programs';
 	var jsmsgAllPrograms = 'All Programs';
 	var jsmsgOpenAndWaitlistedPrograms = 'Open & Waitlisted Programs';
 
 	var jsmsgConfirmSendInvitations = 'Are you sure you wish you send invites to all of the listed members?';
 	var jsmsgBack = 'Back';
 	var jsmsgConfirmDeleteMember = 'Are you sure you wish to delete this member?';
 
 	var jsmsgEmail = 'E-mail';
 	var jsmsgFirstName = 'First Name';
 	var jsmsgLastName = 'Last Name';
 	var jsmsgSelect = 'Select';
 	var jsmsgCancel = 'Cancel';
 	var jsmsgAdd = 'Add';
 
 	var jsmsgIntroNext = 'Next';
 	var jsmsgIntroPrev = 'Back';
 	var jsmsgIntroSkip = 'Skip';
 	var jsmsgIntroDone = 'Done';
 	var jsmsgIntroDoneForever = 'Never Show Again';
 
 	var jsmsgEditCategory = 'Edit Category';
 	var jsmsgAddCategoryLevel = 'Add Category Level';
 	var jsmsgRemoveCategory = 'Remove Category';
 	var jsmsgEditCategoryLevel = 'Edit Category Level';
 	var jsmsgRemoveCategoryLevel = 'Remove Category Level';
 	var jsmsgAddRequirement = 'Add Requirement';
 	var jsmsgAddRequirementGroup = 'Add Requirement Group';
 	var jsmsgEditRequirementGroup = 'Edit Requirement Group';
 	var jsmsgRemoveRequirementGroup = 'Remove Requirement Group';
 	var jsmsgCopyRequirementGroup = 'Copy Requirement Group';
 	var jsmsgPasteRequirementGroup = 'Paste Requirement Group';
 	var jsmsgValueAll = 'All';
 
 
 	var jsmsgCreateANewGroup = 'Create a New Group';
 
 	var jsmsgCheckAll = 'Check All';
 	var jsmsgUncheckAll = 'Uncheck All';
 	var jsmsgSelectOptions = 'Select options';
 	var jsmsgSelectAddOptions = 'Select or Add';
 	var jsmsgNumberSelected = '# selected';
 
 	var jsmsgNewSeasonDates = 'New Season Dates';
 	var jsmsgCopyToSeason = 'Copy To Season';
 	var jsmsgEditProgram = 'Edit Program';
 	var jsmsgEditEvent = 'Edit Event';
 	var jsmsgCopyEvent = 'Copy Event';
 	var jsmsgCopyProgram = 'Copy Program';
 
 	var jsmsgRegGoalCount = 'Required Goal Count:';
 	var jsmsgTrackPassedOnly = 'Track Passed Only';
 	var jsmsgRequired = 'Required';
 
 	var jsmsgFileTooLarge2M = 'The file you have selected is too large. Files larger than 2MB are not supported.';
 	var jsmsgFileTooLarge5M = 'The file you have selected is too large. Files larger than 5MB are not supported.';
 	var jsmsgFileTooLarge15M = 'The file you have selected is too large. Files larger than 15MB are not supported.';
 
 	var jsmsgBrowserOutOfDate = 'The feature you are attempting to use is not supported by your browser.';
 
 	var jsmsgOneLedgerAccountPerClass = function(account_class) {
 		return 'You must create at least one ' + account_class + ' account!';
 	};
 	var jsmsgDuplicateAccountCode = function(account_code, account_class) {
 		return 'Duplicate account code' + " '" + account_code + "' " + 'for account of class ' + account_class;
 	};
 	var jsmsgDuplicateAccountDefault = function(default_link_name, account_class) {
 		return 'You may not duplicate' + " '" + default_link_name + "' " + 'for account of class ' + account_class;
 	};
 
 	var jsmsgAddNewParticipant = 'Add New Participant';
 	var jsmsgSelectParticipant = 'Select Participant';
 	var jsmsgConfirmMerchantChangeNoSave = 'Are you sure you want to change merchants? Your current changes will not be saved.';
 
 	var jsmsgMerchantTabs = [
 		'PAYMENT METHODS',
 		'PAYMENT METHOD GROUPS'
 	];
 
 	var jsmsgUpdateEventsWarning = 'You\'ve adjusted your program location. By doing so, you will adjust ALL events and recurrences to occur at this single location. Would you like to proceed?';
 
 	var jsmsgConfirmDeletePolicy = 'Are you sure you want to delete this policy?';
 
 	var jsmsgCreateNewAddress = '-- Create a new address --';
 
 	var jsmsgSelectDifferentAddress = '-- Select a different saved address --';
 	var jsmsgConfirmDeleteAddress = 'Are you sure you want to delete this address?';
 
 	var jsmsgMerchantPaymentMethodAddText = 'Add %s details';
 	var jsmsgMerchantPaymentMethodUdateText = 'Update %s details';
 
 	var jsmsgConfirmEmptyCartText = 'Are you sure you want to empty your Shopping Cart?';
 	var jsmsgBeginImport = 'Starting Import';
 
 	var jsmsgCreateANewPolicy = 'Create A New Policy';
 	var jsmsgUpdatePolicy = 'Update Policy';
 
 	var jsmsgCreateNew = 'Create New';
 
 	var jsmsgChangeStatusMemberInactive = 'Inactive members will not appear in dropdowns and not be displayed by default on this page. Are you sure you want to continue?';
 	var jsmsgChangeStatusMemberSuspended = 'Suspended members will not be permitted to log into the system, will not appear in dropdowns and not be displayed by default on this page. Are you sure you want to continue?';
 	var jsmsgChangeStatusMemberActive = 'Are you sure you want to reactivate this member?';
 
 	var jsmsgAndCaps = 'AND';
 	var jsmsgOrCaps = 'OR';
 	var jsmsgAllProducts = 'All Products';
 	var jsmsgItemTagExplainerHeader = function(type) {
 		return 'This' + " " + type + " " + 'will apply when the member adds an invoice line item matching the requirements below:';
 	};
 	var jsmsgItemTagExplainerSeasonFootnote = 'Season tags (<span class=\"icon-season\"><\/span>) will apply only to programs. The Season for discounts field currently apply only to season discounts.';
 	var jsmsgItemTagExplainerCategoryLevelFootnote = 'Category level tags (<span class=\"icon-category_level\"><\/span>) will apply only when the invoice line item has been linked directly to the specified category level.';
 
 	var jsmsgLiveRegistration = 'Are you sure you would like to enable \"Live Registrations\"? Once saved, you will not be able to unset this.';
 	var jsmsgConfirmExpiringOrderOnCheckout = "This invoice will expire within 5 minutes and changes will be lost.";
 
 	var jsmsgUseAvailableCredit = 'Use Available Credit';
 
 	var jsmsgOverduePayments = 'Overdue Payments';
 	var jsmsgOutstandingPayments = 'Outstanding Payments';
 	var jsmsgUpcomingPayments = 'Upcoming Payments';
 	var jsmsgUndepositedPayments = 'Undeposited Payments';
 	var jsmsgRecentPayments = 'Recently Processed Transactions';
 
 	var jsmsgInstructorEmail = 'Instructor Email ...';
 	var jsmsgSelectInstructor = 'Select Instructor';
 
 	var jsmsgConfirmRedeemAllTickets = 'Are you sure you would like to apply ALL outstanding ticket redemptions?';
 	var jsmsgConfirmRedeemOneTicket = 'Are you sure you would like to apply 1 redemption to all outstanding tickets?';
 
 	var jsmsgLoadingPopupMessages = [
 		'Powering up to 1.21 gigawatts.',
 		'Uplifting your athletes.',
 		'Looking for Cubert.',
 		'Feeding Cubert.',
 		'Petting Cubert.',
 		'Donning a cape.',
 		'Trying a Superhero Landing!',
 		'The first rule of Uplifter is \'Tell everyone about Uplifter!\'',
 		'Practicing a double salchow.',
 		'Making snow!',
 		'Shoot the duck!',
 		'Practicing a backwards handspring.',
 		'Log roll!',
 		'If you build it, they will register.',
 		'You had me at \'Uplifter\'',
 		'Elementary, my dear Cubert.',
 		'Heeere\'s Hero!',
 		'Open the pod bay doors please, Cubert.',
 		'Nobody puts Cubert in the corner.',
 		'Hasta la vista, Cubert.',
 		'There\'s no place like Uplifter.',
 		'Do you feel lucky? Well, do ya, Cubert?',
 		'I\'ll be back. ...okay, I\'m back.',
 		'Hero, phone home.',
 		'Doing a Kessel Run, back in 12 parsecs.',
 		'Help me, Hero. You\'re my only hope.',
 		'I don\'t feel so good, Mr. Hero.',
 		'This... is... UPLIFTER!',
 		'Cubert CubeCat, multipass.',
 		'Hero is as Hero does.',
 		'Run, Hero! Run!',
 		'Me and Cubert go together like peas and carrots.',
 		'The force is with you, young Hero, but you are not a Jedi yet.',
 		'Who is Cubert Soze?'
 	];
 	var jsmsgCardNumber = 'Card Number';
 	var jsmsgExpiry = 'MM / YY';
 	var jsmsgCVC = 'CVC';
 	var jsmsgConfirmDeleteGCRefund = 'Deleting the refund will reduce the value of the gift certificate by the originally creditted amount.';
   </script>
   <script type="text/javascript">
    server_timezone = -240;
 	lang = 'eng';
 					_ACCOUNTING_SETTING = {"currency":{"symbol":"$","format":{"pos":"%s%v","zero":"%s%v","neg":"- %s%v"},"decimal":".","thousand":",","precision":2},"number":{"precision":2,"thousand":",","decimal":"."},"symbolWithSign":"- $"};
 				_DATE_FORMATS = {"7":"h:mm A","6":"MMMM D, Y [at] h:mm A","5":"MMMM D, Y","4":"MMM D, Y, h:mm A","3":"MMM D, Y","2":"Y-MM-DD h:mm A","1":"Y-MM-DD","8":"h:mm:ss A","9":"Y-MM-DD h:mm:ss A","10":"MMM"};
 				MOMENT_LOCALE = "en-ca";
 	
 			SHORT_DATE = 1;
 				SHORT_DATE_TIME = 2;
 				MEDIUM_DATE = 3;
 				MEDIUM_DATE_TIME = 4;
 				LONG_DATE = 5;
 				LONG_DATE_TIME = 6;
 				TIME_ONLY = 7;
 				TIME_WITH_SEC = 8;
 				SHORT_DATE_TIME_WITH_SEC = 9;
   </script>
   <!--[if lte IE 8]>
 <script type="text/javascript" src="/js/ie.js"></script>
 <script type="text/javascript" src="/js/es5-shim.min.js"></script>
 <script type="text/javascript" src="/js/es5-sham.min.js"></script>
 <![endif]-->
   <script src="/js/es6-shim.min.js" type="text/javascript">
   </script>
   <script src="/js/es6-sham.min.js" type="text/javascript">
   </script>
   <script type="text/javascript">
    var lang = "eng";
   </script>
   <script src="/js/jquery-1.8.3.min.js?1509648422" type="text/javascript">
   </script>
   <script src="/js/jquery-migrate-1.1.1.min.js?1509648422" type="text/javascript">
   </script>
   <script src="/js/jquery-ui-1.10.3.custom.min.js?1509648422" type="text/javascript">
   </script>
   <script src="/js/jquery.multiselect.js?1509648422" type="text/javascript">
   </script>
   <script src="/js/jquery.multiselect.filter.js?1509648422" type="text/javascript">
   </script>
   <script src="/js/multi.min.js?1509648422" type="text/javascript">
   </script>
   <script src="/js/modernizr.custom.js?1509648422" type="text/javascript">
   </script>
   <script src="/js/jquery.flexnav.min.js?1509648422" type="text/javascript">
   </script>
   <script src="/js/jquery.tooltipster.min.js?1509648422" type="text/javascript">
   </script>
   <script src="/js/ui.js?1532596119" type="text/javascript">
   </script>
   <script src="/js/jquery.serializejson.min.js?1520503007" type="text/javascript">
   </script>
   <script src="/js/jquery.ui.touch-punch.min.js?1509648422" type="text/javascript">
   </script>
   <script src="/js/jquery-ui-timepicker-addon.js?1530283476" type="text/javascript">
   </script>
   <script src="/js/introjs.min.js?1509648422" type="text/javascript">
   </script>
   <script src="/js/fancybox/jquery.fancybox-modified-1.3.4.js?1509648422" type="text/javascript">
   </script>
   <script src="/js/knockout-min-3.4.0.js?1509648422" type="text/javascript">
   </script>
   <script src="/js/knockout.mapping-min-2.6.0.js?1509648422" type="text/javascript">
   </script>
   <script src="/js/knockout.validation-min-2.0.3.js?1509648422" type="text/javascript">
   </script>
   <script src="/js/utils/utils.js?1531773403" type="text/javascript">
   </script>
   <script src="/js/moment.min.js?1521904946" type="text/javascript">
   </script>
   <script src="/js/selectize/js/standalone/selectize.min.js?1509648422" type="text/javascript">
   </script>
   <script src="/js/selectize-disabled.js?1520503007" type="text/javascript">
   </script>
   <script src="/js/ko_selectize.js?1527192692" type="text/javascript">
   </script>
   <script src="/js/accounting.min.js?1509648422" type="text/javascript">
   </script>
   <script src="/js/knockout-custom-bindings.js?1527192692" type="text/javascript">
   </script>
   <script type="text/javascript">
    var moment_timezone = 'America/Toronto';
 	if(typeof moment === 'function' && typeof moment.tz === 'function') {
 		moment.tz.setDefault(moment_timezone);
 	}
 
 	moment.locale(MOMENT_LOCALE || 'en');
   </script>
   <script type="text/javascript">
    if (accounting && _ACCOUNTING_SETTING) {
 		accounting.settings = _ACCOUNTING_SETTING
 	}
   </script>
  </head>
  <body id="topPage">
   <script>
    (function(i,s,o,g,r,a,m){i['GoogleAnalyticsObject']=r;i[r]=i[r]||function(){
 	(i[r].q=i[r].q||[]).push(arguments)},i[r].l=1*new Date();a=s.createElement(o),
 	m=s.getElementsByTagName(o)[0];a.async=1;a.src=g;m.parentNode.insertBefore(a,m)
 	})(window,document,'script','//www.google-analytics.com/analytics.js','ga');
 	
 	ga('create', 'UA-53549833-1', {
 	 'cookieDomain': 'www.barrieskatingclub.com'
 	});
 	ga('send', 'pageview');
   </script>
   <noscript>
    <style type="text/css">
     .js_only{
 						display:none;
 					}
    </style>
   </noscript>
   <div id="header">
    <div class="siteTop" id="topNav">
     <div class="fixedContainer">
      <span class="greeting">
      </span>
      <nav class="dropdown">
       <ul id="topNavMenu">
        <li class="Login">
         <a class="" href="/login/" title="Login">
          <span class="menuText">
           Login
          </span>
         </a>
        </li>
       </ul>
      </nav>
      <div class="clear">
      </div>
     </div>
    </div>
    <div class="fixedContainer" id="clubLogo">
     <a href="/">
      <img alt="Barrie Skating Club" data-src-large="/sites/images/top_header.png?1450917442" data-src-small="/sites/images/logo-mobile.png?1450917442" id="headerImage" title="Barrie Skating Club"/>
     </a>
    </div>
    <script>
     setHeaderImage();
    </script>
    <nav class="dropdown" id="mainNav">
     <span class="menuTarget" title="Menu">
     </span>
     <a class="icon-home homeBeta" href="/" title="Home">
     </a>
     <ul class="menuItems" id="mainNavMenu">
      <li class="Programs">
       <a class="" href="/pages/Programs/" title="Programs">
        <span class="menuText">
         Programs
        </span>
       </a>
       <ul>
        <li class="CanSkate">
         <a class="" href="/pages/Programs/CanSkate/" title="CanSkate">
          <span class="menuText">
           CanSkate
          </span>
         </a>
         <ul>
          <li class="CanSkateattheBSC">
           <a class="" href="/pages/Programs/CanSkate/CanSkate-at-the-BSC/" title="CanSkate at the BSC">
            <span class="menuText">
             CanSkate at the BSC
            </span>
           </a>
          </li>
          <li class="SkateCanadaProgramDescription">
           <a class="" href="/pages/Programs/CanSkate/Skate-Canada-Program-Description/" title="Skate Canada Program Description">
            <span class="menuText">
             Skate Canada Program Description
            </span>
           </a>
          </li>
          <li class="Schedule">
           <a class="" href="/pages/Programs/CanSkate/Schedule/" title="Schedule">
            <span class="menuText">
             Schedule
            </span>
           </a>
          </li>
          <li class="BadgeLevels">
           <a class="" href="/pages/Programs/CanSkate/Badge-Levels/" title="Badge Levels">
            <span class="menuText">
             Badge Levels
            </span>
           </a>
          </li>
          <li class="WhatisanNCCPCoach">
           <a class="" href="/pages/Programs/CanSkate/What-is-an-NCCP-Coach/" title="What is an NCCP Coach?">
            <span class="menuText">
             What is an NCCP Coach?
            </span>
           </a>
          </li>
         </ul>
        </li>
        <li class="PreCanSkate">
         <a class="" href="/pages/Programs/PreCanSkate/" title="PreCanSkate">
          <span class="menuText">
           PreCanSkate
          </span>
         </a>
        </li>
        <li class="STARSkate">
         <a class="" href="/pages/Programs/STARSkate/" title="STARSkate">
          <span class="menuText">
           STARSkate
          </span>
         </a>
         <ul>
          <li class="PreJunior">
           <a class="" href="/pages/Programs/STARSkate/Pre-Junior/" title="Pre-Junior">
            <span class="menuText">
             Pre-Junior
            </span>
           </a>
          </li>
          <li class="Junior">
           <a class="" href="/pages/Programs/STARSkate/Junior/" title="Junior">
            <span class="menuText">
             Junior
            </span>
           </a>
          </li>
          <li class="Intermediate">
           <a class="" href="/pages/Programs/STARSkate/Intermediate/" title="Intermediate">
            <span class="menuText">
             Intermediate
            </span>
           </a>
          </li>
          <li class="Senior">
           <a class="" href="/pages/Programs/STARSkate/Senior/" title="Senior">
            <span class="menuText">
             Senior
            </span>
           </a>
          </li>
          <li class="STARSkateTests">
           <a class="" href="/pages/Programs/STARSkate/STARSkate-Tests/" title="STARSkate Tests">
            <span class="menuText">
             STARSkate Tests
            </span>
           </a>
          </li>
          <li class="Competitions">
           <a class="" href="/pages/Programs/STARSkate/STARSkate-Competitions/" title="Competitions">
            <span class="menuText">
             Competitions
            </span>
           </a>
          </li>
         </ul>
        </li>
        <li class="Competitive">
         <a class="" href="/pages/Programs/Competitive/" title="Competitive">
          <span class="menuText">
           Competitive
          </span>
         </a>
        </li>
        <li class="Adult">
         <a class="" href="/pages/Programs/Adult/" title="Adult">
          <span class="menuText">
           Adult
          </span>
         </a>
        </li>
        <li class="ProgramAssistants">
         <a class="" href="/pages/Programs/Program-Assistants/" title="Program Assistants">
          <span class="menuText">
           Program Assistants
          </span>
         </a>
        </li>
        <li class="PowerSkating">
         <a class="" href="/pages/Programs/Power-Skating/" title="Power Skating">
          <span class="menuText">
           Power Skating
          </span>
         </a>
        </li>
       </ul>
      </li>
      <li class="AboutUs">
       <a class="" href="/pages/About-Us/" title="About Us">
        <span class="menuText">
         About Us
        </span>
       </a>
       <ul>
        <li class="PresidentsMessage">
         <a class="" href="/pages/About-Us/President-s-Message/" title="President's Message">
          <span class="menuText">
           President's Message
          </span>
         </a>
        </li>
        <li class="Community">
         <a class="" href="/pages/About-Us/Community/" title="Community">
          <span class="menuText">
           Community
          </span>
         </a>
        </li>
        <li class="Volunteerism">
         <a class="" href="/pages/About-Us/Volunteerism/" title="Volunteerism">
          <span class="menuText">
           Volunteerism
          </span>
         </a>
        </li>
        <li class="BoardofDirectors">
         <a class="" href="/pages/About-Us/Board-of-Directors/" title="Board of Directors">
          <span class="menuText">
           Board of Directors
          </span>
         </a>
        </li>
        <li class="History">
         <a class="" href="/pages/About-Us/History/" title="History">
          <span class="menuText">
           History
          </span>
         </a>
        </li>
        <li class="CorporateSponsorship">
         <a class="" href="/pages/About-Us/Corporate-Sponsorship/" title="Corporate Sponsorship">
          <span class="menuText">
           Corporate Sponsorship
          </span>
         </a>
        </li>
        <li class="Octoberfest">
         <a class="" href="/pages/About-Us/Octoberfest/" title="Octoberfest">
          <span class="menuText">
           Octoberfest
          </span>
         </a>
        </li>
        <li class="TheBSCandMariposa">
         <a class="" href="/pages/About-Us/The-BSC-and-Mariposa/" title="The BSC and Mariposa">
          <span class="menuText">
           The BSC and Mariposa
          </span>
         </a>
        </li>
        <li class="SkateCanadaParentCodeofConduct">
         <a class="" href="/pages/About-Us/Skate-Canada-Parent-Code-of-Conduct/" title="Skate Canada Parent Code of Conduct">
          <span class="menuText">
           Skate Canada Parent Code of Conduct
          </span>
         </a>
        </li>
        <li class="SkateCanadaMissionStatement">
         <a class="" href="/pages/About-Us/Skate-Canada-Mission-Statement/" title="Skate Canada Mission Statement">
          <span class="menuText">
           Skate Canada Mission Statement
          </span>
         </a>
        </li>
       </ul>
      </li>
      <li class="Schedules">
       <a class="" href="/pages/Schedules/" title="Schedules">
        <span class="menuText">
         Schedules
        </span>
       </a>
       <ul>
        <li class="MasterSchedule">
         <a class="" href="/pages/Schedules/Master-Schedule/" title="Master Schedule">
          <span class="menuText">
           Master Schedule
          </span>
         </a>
        </li>
        <li class="PreCanCanSkatebyDay">
         <a class="" href="/pages/Schedules/PreCan-CanSkate-by-Day/" title="PreCan &amp; CanSkate by Day">
          <span class="menuText">
           PreCan &amp; CanSkate by Day
          </span>
         </a>
        </li>
        <li class="PreCanCanSkatebyLocation">
         <a class="" href="/pages/Schedules/PreCan-CanSkate-by-Location/" title="PreCan &amp; CanSkate by Location">
          <span class="menuText">
           PreCan &amp; CanSkate by Location
          </span>
         </a>
        </li>
        <li class="PowerSkating">
         <a class="" href="/pages/Schedules/Power-Skating/" title="Power Skating">
          <span class="menuText">
           Power Skating
          </span>
         </a>
        </li>
       </ul>
      </li>
      <li class="Coaches">
       <a class="" href="/pages/Coaches/" title="Coaches">
        <span class="menuText">
         Coaches
        </span>
       </a>
      </li>
      <li class="Registration">
       <a class="" href="/registration/" title="Registration">
        <span class="menuText">
         Registration
        </span>
       </a>
      </li>
      <li class="News">
       <a class="" href="/news/" title="News">
        <span class="menuText">
         News
        </span>
       </a>
      </li>
      <li class="ContactUs">
       <a class="" href="/contact-us/" title="Contact Us">
        <span class="menuText">
         Contact Us
        </span>
       </a>
      </li>
     </ul>
     <div class="clear">
     </div>
    </nav>
   </div>
   <div id="content">
    <div class="fixedContainer clearfix">
     <div id="topNotices">
     </div>
     <div class="contentSection">
      <div class="mainContent">
       <div>
        <p style="text-align: center;">
        </p>
        <h1 style="text-align: center;">
         <span style="color: #0000ff; font-size: 24pt;">
          <strong>
           Welcome to the website for the
          </strong>
         </span>
        </h1>
        <h1 style="text-align: center;">
         <span style="color: #0000ff; font-size: 24pt;">
          <strong>
           BARRIE SKATING CLUB!
          </strong>
         </span>
        </h1>
        <p style="text-align: center;">
         <span style="font-size: 14pt; color: #ff0000;">
          For information about all of our programs please click on the PROGRAMS tab above. There you will also find a printable brochure with all of our programs, dates, etc.
         </span>
        </p>
        <p style="text-align: center;">
         <span style="font-size: 14pt; color: #993366;">
          We continue to work on bringing you information that will hopefully answer all of your questions about our skating programs. While some sections of the website are still under construction, we hope you will find the information that you need. Please remember that if you have questions at any time, you are welcome to contact our office at
          <span style="color: #0000ff;">
          </span>
         </span>
        </p>
        <p style="text-align: center;">
         <span style="font-size: 14pt; color: #993366;">
          <span style="color: #0000ff;">
           <strong>
            705-719-2084
           </strong>
          </span>
          or by email at info@barrieskatingclub.com...HAPPY SKATING!!
         </span>
        </p>
        <p style="text-align: center;">
         <strong>
          <span style="font-size: 18pt; color: #993366;">
           <a href="/sites/files/2017-2018 SKATING REGISTRATION PAMPHLET.pdf">
            2017-2018 SKATING REGISTRATION BROCHURE
           </a>
          </span>
         </strong>
        </p>
       </div>
       <div class="mainBody fixedContainer threeColumns">
        <div class="col">
         <p style="text-align: center;">
         </p>
         <h1 style="text-align: center;">
          <span style="color: #3366ff; font-family: arial, helvetica, sans-serif;">
           <img border="0" src="/sites/files/CANSKATE_logo.png"/>
          </span>
         </h1>
         <p>
         </p>
         <p>
         </p>
         <p style="text-align: center;">
          <img border="0" src="/sites/files/StarSkate-450x360-150x150.jpg"/>
         </p>
         <p style="text-align: center;">
          <img border="0" src="/sites/files/comp skate logo.gif"/>
         </p>
         <p style="text-align: center;">
          <img border="0" src="/sites/files/CanPowerSkate-450x290-300x193.jpg"/>
         </p>
         <hr/>
         <p>
         </p>
         <p>
          <iframe allowfullscreen="true" class="twitter-timeline twitter-timeline-rendered" data-widget-id="735440903674974209" frameborder="0" id="twitter-widget-0" scrolling="no" style="padding: 0px; border: currentColor; width: 520px; height: 600px; margin-top: 0px; margin-bottom: 0px; display: inline-block; visibility: visible; position: static; min-height: 200px; min-width: 180px; max-width: 100%;" title="Twitter Timeline">
          </iframe>
         </p>
         <p>
         </p>
        </div>
        <div class="col">
         <p style="text-align: center;">
          <span style="color: #ff6600; text-decoration: underline;">
           <span style="font-size: 24pt; text-decoration: underline;">
            Important Date
           </span>
          </span>
          <span style="color: #0000ff;">
           <span style="color: #ff6600; text-decoration: underline;">
            <span style="font-size: 24pt;">
             s
            </span>
           </span>
          </span>
         </p>
         <p style="text-align: center;">
         </p>
         <p style="text-align: center;">
          <span style="font-size: 18pt;">
           <span style="color: #0000ff;">
            Registration for our 2018/2019 Fall &amp; Winter programs will go live approximately the 3rd week of August. Programs begin in October. Please watch here for updates!
           </span>
          </span>
         </p>
         <p>
         </p>
         <p>
         </p>
         <p>
         </p>
         <p style="text-align: center;">
         </p>
         <p style="text-align: center;">
         </p>
         <p style="text-align: center;">
          <span style="color: #0000ff; font-size: 24pt;">
           <strong>
            Program Assistants wanted !!
           </strong>
          </span>
         </p>
         <p style="text-align: center;">
          <strong>
           <span style="font-size: 14pt;">
            <a href="/sites/files/Program Assistants 2017 Volunteer Form.pdf" target="_top">
             Program Assistants 2017 Volunteer Form
            </a>
           </span>
          </strong>
         </p>
         <p>
          <span style="font-size: 14pt;">
          </span>
         </p>
         <p>
         </p>
         <p>
         </p>
         <p>
         </p>
         <p>
         </p>
        </div>
        <div class="col">
         <p>
          <strong>
           <span style="color: #993366; font-size: 18pt;">
            Save the Date - BSC STARSkate Banquet
           </span>
          </strong>
         </p>
         <p>
          The Barrie Skating Club Banquet for our Junior, Intermediate and Senior STARSkaters will be taking place on Friday April 13th. Tickets will be $25. Doors will open at 5:30. Dinner is served at 6, followed by a short awards presentation and dance, concluding at 10pm. Tickets are now available to purchase through the website. Click on the 'registration' tab above, and then 'products' to find the banquet tickets.
         </p>
         <p>
         </p>
         <p>
          CANSKATE &amp; PRE-CANSKATE FAMILIES
          <strong>
           <span style="font-size: medium;">
            <span style="color: #ff0000;">
             BUILD YOUR OWN COMBO - SAVE $175
            </span>
           </span>
           <span style="font-family: Times New Roman,Times New Roman; font-size: medium;">
            …
           </span>
          </strong>
          <span style="font-family: Times New Roman,Times New Roman; font-size: small;">
           <span style="font-family: Times New Roman,Times New Roman; font-size: small;">
            For Skaters who want to skate twice weekly through both the Fall and Winter sessions, choose 2 Fall Pre-Canskate or CanSkate programs and 2 Wnter Pre-Canskate or CanSkate programs and your fee will automatically
           </span>
          </span>
          <strong>
           <span style="font-size: medium;">
            be reduced to $465 total
           </span>
          </strong>
          <span style="font-family: Times New Roman,Times New Roman; font-size: small;">
           <span style="font-family: Times New Roman,Times New Roman; font-size: small;">
            (for 4, 9 week programs...pro-rated for 8/10 week sessions) at check-out, when using the online registration system.
           </span>
          </span>
         </p>
         <hr/>
         <p>
          <strong>
           <span style="color: #993366; font-size: 18pt;">
            Installment Payment
           </span>
          </strong>
         </p>
         <p>
          <span style="color: #000080;">
           Again this year...skaters registering through our online system for our full year STARSkate payments will be able to register in 3 installments. The first is due at time of registration, with the next 2 payable Nov 1st and Dec 1st.
          </span>
         </p>
         <hr/>
         <p>
         </p>
         <p>
          <span style="color: #993300; font-size: 14pt;">
           <strong>
            Boston Pizza Anyone???
           </strong>
          </span>
         </p>
         <p>
          Did you know that if you like to eat at Boston Pizza, you can support our club just by enjoying your meal!!??!! When the bill comes, just let them know you're supporting the Barrie Skating Club and a percentage of your total bill comes right back to the club!
         </p>
         <hr/>
         <p>
         </p>
         <p>
          <a href="https://www.facebook.com/Barrie-Skating-Club-100547886709767/" target="_blank" title="FaceBook">
           <img border="0" height="46" src="/sites/files/facebook.png" width="191"/>
          </a>
         </p>
         <p>
          <a href="https://twitter.com/BSCSkating" target="_blank" title="twitter">
           <img border="0" height="109" src="/sites/files/twitter.jpg" width="201"/>
          </a>
         </p>
         <p>
          <a href="https://www.instagram.com/bscskating/" target="_blank">
           <img border="0" height="115" src="/sites/files/Instagram-Logo.jpg" width="186"/>
          </a>
         </p>
        </div>
       </div>
      </div>
      <div class="clear">
      </div>
     </div>
     <div class="clear">
     </div>
    </div>
   </div>
   <div class="sponsorBar">
    <div class="" style="display: block;">
     <span class="subHeaderTitle">
      Sponsors
     </span>
     <div class="fixedContainer">
      <img border="0" src="/sites/files/delta%20logo_EDIT1.png"/>
      <img border="0" src="/sites/files/olg%20logo.jpg"/>
     </div>
    </div>
   </div>
   <div id="footer">
    <footer>
     <div class="fixedContainer clearfix">
      <span>
       <b>
        Barrie Skating Club
       </b>
       <br/>
       Address: Box 35024  Barrie, Ontario  L4N 9J7 |  			
 				(705) 719-2084 |
       <a href="mailto: info@barrieskatingclub.com">
        info@barrieskatingclub.com
       </a>
      </span>
      <ul>
       <li>
        <a href="/sitemap/">
         Sitemap
        </a>
       </li>
       <li>
        <a href="/pages/Policies/">
         Policies
        </a>
       </li>
      </ul>
      <span class="copyright">
       © 2018 powered by
       <a href="http://www.uplifterinc.com" target="_blank">
        Uplifter Inc.
       </a>
      </span>
     </div>
    </footer>
   </div>
   <script id="siteFieldEdit" type="text/html">
    <section class="site-field-wrap" data-bind="css: { isRequired: site_field().required(), allowMultiples: site_field().allowMultiples() }">
 		<header>
 			<label>
 				<!-- ko text: site_field().name --><!-- /ko -->
 				<!-- ko if: getError() -->
 				<span class="icon-alert-circled staticIcon tooltip" data-bind="attr: {title: getError}"></span>
 				<!-- /ko -->
 				<!-- ko if: site_field().help_text -->
 				<span class="icon-help tooltip" data-bind="attr: { title: site_field().help_text}"></span>
 				<!-- /ko -->
 			</label>
 		</header>
 		<!-- ko if: mode() == 'simple' -->
 			<div class="site-field-values">
 
 				<!-- ko if: allowMultiples -->
 				<div class="m-table site-field-value-wrap">
 				<!-- ko foreach: values -->
 					<div class="m-row site-field-value">
 						<div class="m-cell-lock sevenEighth">
 							<input type="text" data-bind="textInput: value, css: $parent.getInputClass, change: $parent.validateValue" />
 						</div>
 						<div class="m-cell-lock oneEighth" >
 							<span class="icon-delete" data-bind="click: $parent.removeValue"></span>
 						</div>
 					</div>
 				<!-- /ko -->
 				</div>
 				<!-- /ko -->
 
 				<!-- ko ifnot: allowMultiples -->
 				<div>
 					<!-- ko if: allowUpdate -->
 					<div class="m-row site-field-value">
 						<div class="m-cell-lock sevenEighth">
 							<input type="text" data-bind="textInput: firstValue(), css: getInputClass, change: $parent.validateValue" />
 						</div>
 						<div class="m-cell-lock oneEighth">
 							<span class="icon-delete" data-bind="click: removeValue"></span>
 						</div>
 					</div>
 					<!-- /ko -->
 
 					<!-- ko ifnot: allowUpdate -->
 					<span data-bind="text: formatValue()"></span>
 					<!-- /ko -->
 				</div>
 				<!-- /ko -->
 
 			</div>
 			<!-- ko if: allowMultiples -->
 			<footer> <span class="icon-add iconBtn" data-bind="click: addValue">Add Row</span>
 			</footer>
 			<!-- /ko -->
 		<!-- /ko -->
 		<!-- ko if: mode() == 'select' -->
 			<div class="site-field-values">
 				<!-- ko if: allowMultiples -->
 					<!-- ko if: allowFreeForm -->
 					<select data-bind="selectize: selectOptions,
 						selectedOptions: selectedOptions,
 						selectizeDropdownParent: 'body',
 						css: getInputClass,
 						attr: { name: getInputName },
 						optionsValue: 'name',
 						optionsMaxItems: maxSelections() || null,
 						optionsCreate: function(input) {
 							return  {id: input, name: input};
 						},
 						onItemAdd: function () {
 							updateFB();
 							$('*:focus').blur();
 						},
 						selectizePlaceholder: 'Select or Add'" multiple="multiple"></select>
 					<!-- /ko -->
 					<!-- ko ifnot: allowFreeForm -->
 					<select data-bind="selectize: selectOptions,
 						selectedOptions: selectedOptions,
 						selectizeDropdownParent: 'body',
 						css: getInputClass,
 						attr: { name: getInputName },
 						optionsValue: 'name',
 						optionsMaxItems: maxSelections() || null,
 						onItemAdd: function () {
 							updateFB();
 							$('*:focus').blur();
 						},
 						selectizePlaceholder: ' -- '" multiple="multiple"></select>
 					<!-- /ko -->
 				<!-- /ko -->
 				<!-- ko ifnot: allowMultiples -->
 					<!-- ko if: allowFreeForm -->
 					<select data-bind="selectize: selectOptions,
 						selectedOptions: selectedOptions,
 						selectizeDropdownParent: 'body',
 						css: getInputClass,
 						attr: { name: getInputName },
 						optionsValue: 'name',
 						optionsCreate: function(input){
 							setValues([input]);
 							return  {id: input, name: input};
 						},
 						selectizePlaceholder: 'Select or Add'"></select>
 					<!-- /ko -->
 					<!-- ko ifnot: allowFreeForm -->
 					<select data-bind="selectize: selectOptions,
 						selectedOptions: selectedOptions,
 						selectizeDropdownParent: 'body',
 						css: getInputClass,
 						attr: { name: getInputName },
 						optionsValue: 'name',
 						selectizePlaceholder: ' -- '"></select>
 					<!-- /ko -->
 				<!-- /ko -->
 			</div>
 		<!-- /ko -->
 		<!-- ko if: mode() == 'image' || mode() == 'file' -->
 			<div class="site-field-values">
 				<!-- ko foreach: values -->
 				<div class="m-row site-field-value" data-bind="if: value() !== 'deleted'">
 					<div class="m-cell-lock sevenEighth">
 						<a target="_blank" data-bind="css: { 'icon-file': $parent.mode() == 'file' }, attr: { href: $parent.getFileSrc(value()), download: $parent.getFileName(value()) }">
 							<!-- ko if: $parent.mode() == 'image' -->
 							<img style="min-width: 50px; max-height: 300px;" data-bind="attr: { src: $parent.getThumbnailSrc(value()) }"/>
 							<!-- /ko -->
 							<p data-bind="text: $parent.getFileName(value())"></p>
 						</a>
 					</div>
 					<div class="m-cell-lock oneEighth">
 						<span class="icon-delete tooltip" title="Delete" data-bind="click: $parent.removeValue"></span>
 					</div>
 				</div>
 				<!-- /ko -->
 				<!-- ko if: !values().length || values()[0].value() === 'deleted' -->
 				<input type="file" data-bind="event: { change: selectFile($element)}">
 				<!-- /ko -->
 			</div>
 		<!-- /ko -->
 		<!-- ko if: mode() === 'instructor' -->
 		<div class="site-field-values">
 			<!-- ko if: allowInstructorCreation -->
 				<!-- ko if: allowMultiples -->
 					<!-- ko if : values().length -->
 					<ul class="selectlist-list" data-bind="foreach: values">
 						<li class="m-row selectlist-item">
 								<span class="m-cell-lock sevenEighth" data-bind="text: $parent.getInstructorName(value())">
 								</span>
 							<div class="m-cell-lock oneEighth textRight">
 								<span class="icon-delete" data-bind="click: $parent.removeValue"></span>
 							</div>
 						</li>
 					</ul>
 					<!-- /ko -->
 
 					<!-- ko ifnot: instructor -->
 					<span class="m-cell-lock sevenEighth">
 						<input type="text" data-bind="instructorFieldAutoComplete: $data, css: $parent.getInputClass" placeholder="Instructor Email ..."/>
 					</span>
 					<span class="m-cell-lock oneEighth textRight">
 						<!-- ko if: error -->
 							<span class="icon-alert-circled tooltip icon" data-bind="attr: { title: error }"></span>
 						<!-- /ko -->
 					</span>
 					<!-- /ko -->
 				<!-- /ko -->
 
 				<!-- ko ifnot: allowMultiples -->
 					<!-- ko if: firstValue() && !firstValue()() && !instructor() -->
 					<span class="m-cell-lock sevenEighth">
 						<input type="text" data-bind="instructorFieldAutoComplete: $data, css: $parent.getInputClass" placeholder="Instructor Email ..."/>
 					</span>
 					<span class="m-cell-lock oneEighth textRight">
 						<!-- ko if: error -->
 							<span class="icon-alert-circled tooltip icon" data-bind="attr: { title: error }"></span>
 						<!-- /ko -->
 					</span>
 					<!-- /ko -->
 					<!-- ko if: firstValue() && firstValue()() -->
 					<span class="m-cell-lock sevenEighth" data-bind="text: getInstructorName(firstValue())"></span>
 					<div class="m-cell-lock oneEighth textRight">
 						<span class="icon-delete" data-bind="click: removeValue"></span>
 					</div>
 					<!-- /ko -->
 				<!-- /ko -->
 			<!-- /ko -->
 			<!-- ko ifnot: allowInstructorCreation -->
 
 				<!-- ko if: allowMultiples -->
 				<select data-bind="css: getInputClass,
 					event: {change: selectAddValue($element)},
 					attr: {name: getInputName},
 					options: unselectedOptions,
 					optionsText: 'name',
 					optionsValue: function (item) {
 						return JSON.stringify({instructor_id: item.instructor_id()})
 					},
 					optionsCaption: ' -- '"></select>
 				<ul class="selectlist-list" data-bind="foreach: values">
 					<li class="m-row selectlist-item">
 						<span class="m-cell-lock sevenEighth" data-bind="text: $parent.getInstructorName(value())">
 						</span>
 						<div class="m-cell-lock oneEighth textRight">
 							<span class="icon-delete" data-bind="click: $parent.removeValue"></span>
 						</div>
 					</li>
 				</ul>
 				<!-- /ko -->
 				<!-- ko ifnot: allowMultiples -->
 					<!-- ko if: SiteField.instructors()() !== false -->
 					<select data-bind="value: firstValue(),
 						css: getInputClass,
 						attr: {name: getInputName},
 						options: selectOptions,
 						optionsText: 'name',
 						optionsValue: function (item) {
 							return JSON.stringify({instructor_id: item.instructor_id()})
 						},
 						optionsCaption: ' -- '"></select>
 					<!-- /ko -->
 					<!-- ko if: SiteField.instructors()() === false --> Loading ... <!-- /ko -->
 				<!-- /ko -->
 
 			<!-- /ko -->
 
 			<!-- ko if: instructor -->
 			<form data-bind="with: instructor">
 				<input type="text" data-bind="textInput: email" placeholder="E-mail" disabled="disabled">
 				<input type="text" data-bind="textInput: first_name" placeholder="First Name">
 				<input type="text" data-bind="textInput: last_name" placeholder="Last Name">
 
 				<div class="textRight">
 					<button class="btnAction cancelButton" data-bind="click: function(){$parent.instructor(null)}">Cancel</button>
 					<button class="btnAction saveButton" data-bind="enable: allowSave, click: $parent.createInstructor">Add</button>
 				</div>
 			</form>
 			<!-- /ko -->
 		</div>
 		<!-- /ko -->
 	</section>
   </script>
   <script id="siteFieldView" type="text/html">
    <section class="site-field-wrap">
 		<header>
 			<label>
 				<span data-bind="text: site_field().name"></span>
 				<!-- ko if: getError() -->
 				<span class="icon-alert-circled staticIcon tooltip" data-bind="attr: {title: getError}"></span>
 				<!-- /ko -->
 				<!-- ko if: visibilityWarning() -->
 				<span class="icon-fieldUnavailable tooltip" title="This field will be hidden from members."></span>
 				<!-- /ko -->
 			</label>
 			<!-- ko if: site_field().context() === 'user' || site_field().context() === 'participant' -->
 			<small>(<span data-bind="text: context().name"></span>)</small>
 			<!-- /ko -->
 		</header>
 		<!-- ko if: mode() == 'simple' -->
 		<div class="site-field-values m-table">
 			<!-- ko if: allowMultiples -->
 			<div class="siteFieldMultiValue">
 				<!-- ko if: values().length -->
 				<!-- ko foreach: values -->
 				<div class="siteFieldData">
 					<span data-bind="text: value"></span>
 				</div>
 				<!-- /ko -->
 				<!-- /ko -->
 				<!-- ko ifnot: values().length > 1 || firstValue() --> Not Set <!-- /ko -->
 			</div>
 			<!-- /ko -->
 
 			<!-- ko ifnot: allowMultiples -->
 			<div class="siteFieldData">
 				<!-- ko if: firstValue() -->
 				<span data-bind="text: firstValue()"></span>
 				<!-- /ko -->
 				<!-- ko ifnot: firstValue() --> Not Set <!-- /ko -->
 			</div>
 			<!-- /ko -->
 		</div>
 		<!-- /ko -->
 
 		<!-- ko if: mode() == 'select' -->
 			<div class="site-field-values">
 				<div class="siteFieldData">
 					<!-- ko if: allowMultiples -->
 					<span data-bind="text: selectedOptions()"></span>
 					<!-- /ko -->
 					<!-- ko ifnot: allowMultiples -->
 					<span data-bind="text: firstValue()"></span>
 					<!-- /ko -->
 				</div>
 			</div>
 		<!-- /ko -->
 
 		<!-- ko if: mode() == 'image' || mode() == 'file' -->
 		<div class="site-field-values">
 			<!-- ko foreach: values -->
 			<a target="_blank" data-bind="css: { 'icon-file': $parent.mode() == 'file' }, attr: { href: $parent.getFileSrc(value()), download: $parent.getFileName(value()) }">
 				<!-- ko if: $parent.mode() == 'image' -->
 				<img style="min-width: 100px; max-height: 300px;" data-bind="attr: { src: $parent.getThumbnailSrc(value()) }"/>
 				<!-- /ko -->
 				<span data-bind="text: $parent.getFileName(value())"></span>
 			</a>
 			<!-- /ko -->
 		</div>
 		<!-- /ko -->
 
 		<!-- ko if: mode() == 'instructor' -->
 		<div class="site-field-values">
 			<!-- ko if: values().length -->
 			<!-- ko foreach: values -->
 			<div class="siteFieldData">
 				<span data-bind="text: $parent.getInstructorName(value())"></span>
 			</div>
 			<!-- /ko -->
 			<!-- /ko -->
 			<!-- ko ifnot: values().length > 1 || firstValue() --> Not Set <!-- /ko -->
 		</div>
 		<!-- /ko -->
 	</section>
   </script>
   <script id="editOrderItemTemp" type="text/html">
    <div id="editOrderItemModal" class="popContent">
 		<header class="headerDivider">
 			<!-- ko if: order_item -->
 			<div class="m-row" data-bind="with: order_item">
 				<div class="m-cell-lock threeFourth">
 					<h2 data-bind="text: local_string[lang].summary"></h2>
 					<!-- ko if: product().program -->
 					<span class="m-cellpad-v">
 						<div class="nowhitespace metaData inlineBlock">
 							
 							<span class="icon-calendar-blank staticIcon" title="Start &amp; End Date" data-bind="text: (function(){
 								return (product().program.start_date() != product().program.end_date() ? moment(product().program.start_date()).locale(false).format('LL') + ' - ' + moment(product().program.end_date()).locale(false).format('LL') : moment(product().program.start_date()).locale(false).format('LL'))
 								})()"></span>
 							
 						</div>
 						<div class="nowhitespace metaData inlineBlock">
 							<span class="icon-clock staticIcon" title="Time" data-bind="text: product().program.day_time"></span>
 						</div>
 					</span>
 					<!-- /ko -->
 				</div>
 				<div class="m-cell-lock oneFourth textRight">
 					<div class="m-cellpad">
 						<div class="originalPrice" data-bind="visible: original_item_price() > discount_price(), text: original_extended_price.currency()"></div>
 						<div class="subtotal" data-bind="text: total.currency()"></div>
 					</div>
 				</div>
 			</div>
 			<!-- /ko -->
 
 			<!-- ko ifnot: order_item -->
 				<!-- ko if: $root.itemAdded() -->
 				<h1 class="textCenter">Item Added</h1>
 				<!-- /ko -->
 			<!-- /ko -->
 		</header>
 		<div class="popBody">
 			<!-- ko if: order_item -->
 			<div data-bind="with: order_item">
 				<div data-bind="with: $root">
 						<div class="noticeMessage fixedContainer">
 			<!-- ko if: errors().length -->
 		<div class="error"> <strong>You have encountered the following error(s) on this page:</strong> <ul data-bind="foreach: errors">
 				<li class="errorMsg" data-bind="html: $data"></li>
 			</ul>
 		</div>
 		<!-- /ko -->
 		<!-- ko if: warnings().length -->
 		<div class="warnings">
 			<ul data-bind="foreach: warnings">
 				<li class="warningMsg" data-bind="html: $data"></li>
 			</ul>
 		</div>
 		<!-- /ko -->
 		<!-- ko if: typeof success === 'function' && success() && success().length -->
 		<ul class="success" data-bind="foreach: success">
 			<li class="successMsg" data-bind="text: $data"></li>
 		</ul>
 		<!-- /ko -->
 		
 </div>				</div>
 				<!-- ko if: registration() -->
 					<h3 data-bind="text: $root.title"></h3>
 					<table data-bind="foreach: $root.dropdowns">
 						<tr>
 							<th data-bind="text: $index() + 1 + '.'" width="10%"></th>
 							
 							<td data-bind="attr: (function(){return $root.fromWaitList() ? {width: '90%'} : {width: '80%'}})()">
 								
 								<select class="fullWidth" data-bind="selectize: options,
 										optionsText: 'dropdownLabel',
 										optionsValue: 'participant_id',
 										value: participant_id,
 										selectizePlaceholder: '--',
 										selectizeDropdownParent: 'body',
 										selectizeOnType: adjustDropdown,
 										selectizeOnDropdownOpen: adjustDropdown,
 										selectizeDisable: $root.fromWaitList()"></select>
 							</td>
 							<!-- ko if: !$root.fromWaitList() -->
 							<td class="textRight" width="10%">
 								<!-- ko if: $root.dropdowns().length > 1 -->
 								<span class="icon-delete" title="Delete" data-bind="click: $root.removeParticipant"></span>
 								<!-- /ko-->
 							</td>
 							<!-- /ko-->
 						</tr>
 					</table>
 					<!-- ko if: product().program.maximum_participants_per_registration() > 1 -->
 					<div class="m-row">
 						<div class="m-cell oneHalf">
 							<span class="m-cellpad">
 								<span data-bind="text: $root.selectedParticipantIds().length"></span> participants selected. You must select between <span data-bind="text: product().program.minimum_participants_per_registration"></span> and <span data-bind="text: product().program.maximum_participants_per_registration"></span> participants. </span>
 						</div>
 						<div class="m-cell oneHalf textRight"> <span class="m-cellpad"> <span class="icon-add iconBtn" data-bind="click: $root.addParticipant, visible: $root.showAddIcon">Add Participant</span>
 							</span>
 						</div>
 					</div>
 					<!-- /ko -->
 				<!-- /ko -->
 
 
 				<!-- ko if: !registration() && apply_to() === 'participant' -->
 				<div class="field sectionSpacer"> <label for="">Purchasing for:</label> <!-- ko if: !auto_added() && (!order_item_id() || !subscription_id()) -->
 						<!-- ko with: dropdown -->
 						<select data-bind="selectize: options,
 								optionsText: 'dropdownLabel',
 								optionsValue: 'participant_id',
 								value: participant_id,
 								selectizePlaceholder: '--',
 								selectizeDropdownParent: 'body',
 								selectizeOnType: adjustDropdown,
 								selectizeOnDropdownOpen: adjustDropdown,
 								selectizeDisable: $root.fromWaitList()"></select>
 						<!-- /ko -->
 					<!-- /ko -->
 					<!-- ko if: !(!auto_added() && (!order_item_id() || !subscription_id())) -->
 					<span data-bind="text: participant().name"></span>
 					<!-- /ko -->
 				</div>
 				<!-- /ko -->
 
 				<!-- ko if: $root.requireSFS() && site_field_values().length -->
 				<div class="site-fields threeColumns siteFieldEditable">
 					<!-- ko foreach: site_field_values -->
 					<div data-bind="template: 'siteFieldEdit'" class="col"></div>
 					<!-- /ko -->
 				</div>
 				<!-- /ko -->
 			</div>
 			<!-- /ko -->
 
 			<!-- ko ifnot: order_item -->
 				<!-- ko if: $root.itemAdded() -->
 				<div class="textCenter">
 					<div class="cartItemAdded">
 						<div class="staticIcon icon-check-circle-o"></div>
 						<div class="staticIcon icon-cart"></div>
 					</div>
 				</div>
 				<!-- /ko -->
 				<div data-bind="with: $root">
 					<!-- ko if: warnings().length && typeof $root.warningsByKey()['registrationFull'] === 'undefined' --> <span class="warnings alertText m-cellpad itemTitle"> Your item has been added to your cart, but you may not be able to proceed with your checkout because: </span>
 					<!-- /ko -->
 						<div class="noticeMessage fixedContainer">
 			<!-- ko if: errors().length -->
 		<div class="error"> <strong>You have encountered the following error(s) on this page:</strong> <ul data-bind="foreach: errors">
 				<li class="errorMsg" data-bind="html: $data"></li>
 			</ul>
 		</div>
 		<!-- /ko -->
 		<!-- ko if: warnings().length -->
 		<div class="warnings">
 			<ul data-bind="foreach: warnings">
 				<li class="warningMsg" data-bind="html: $data"></li>
 			</ul>
 		</div>
 		<!-- /ko -->
 		<!-- ko if: typeof success === 'function' && success() && success().length -->
 		<ul class="success" data-bind="foreach: success">
 			<li class="successMsg" data-bind="text: $data"></li>
 		</ul>
 		<!-- /ko -->
 		
 </div>				</div>
 			<!-- /ko -->
 		</div>
 		
 			<footer class="footerDivider buttonBar">
 				<div class="m-row xsmallHide">
 					<div class="m-cell-lock oneHalf textLeft">
 						<div class="m-cellpad">
 							<!-- ko if: !$root.itemAdded() --> <a href="/users/add-child.php" target="_parent" class="btnAction">Add New Participant</a> <!-- /ko -->
 						</div>
 					</div>
 					<div class="m-cell-lock oneHalf textRight">
 						<div class="m-cellpad">
 							<!-- ko if: order_item -->
 								<div data-bind="with: order_item">
 									<button class="btnAction closeWindow" data-bind="click: function(data){$root.processModal(0, null, null)}">Cancel</button>
 									<!-- ko if: order_item_id() || order.order_id() -->
 										<!-- ko if: $root.allowSave() -->
 											<button class="btnAction closeWindow" data-bind="click: function(data){$root.processModal(1, data, 'EditOrderItem')}">Save</button>
 										<!-- /ko -->
 										<!-- ko ifnot: $root.allowSave() -->
 											<button class="btnAction" disabled="disabled">Save</button>
 										<!-- /ko -->
 									<!-- /ko -->
 									<!-- ko if: !(order_item_id() || order.order_id()) -->
 										<!-- ko if: !$root.fromWaitList() -->
 											<!-- ko if: $root.allowSave() -->
 												<button class="btnAction closeWindow" data-bind="click: function(data){$root.processModal(1, data, 'add_order_item')}"> Add <!-- ko if: $root.next() --> & go to next item <!-- /ko -->
 												</button>
 											<!-- /ko -->
 											<!-- ko ifnot: $root.allowSave() -->
 												<button class="btnAction" disabled="disabled"> Add <!-- ko if: $root.next() --> & go to next item <!-- /ko -->
 												</button>
 											<!-- /ko -->
 										<!-- /ko -->
 										<!-- ko if: $root.fromWaitList() -->
 											<button class="btnAction closeWindow" data-bind="click: function(data){$root.processModal(1, data, 'register_from_waitlist')}">Add</button>
 										<!-- /ko -->
 									<!-- /ko -->
 								</div>
 							<!-- /ko -->
 							<!-- ko ifnot: order_item -->
 								<!-- ko if: $root.showViewCart() && !$root.addedFromGet() --> <a href="/registration/checkout/" target="_parent" class="btnAction">View Cart</a> <!-- /ko -->
 								<button class="btnAction closeWindow" data-bind="click: function(data){$root.processModal(0, null, null)}">Close</button>
 							<!-- /ko -->
 						</div>
 					</div>
 				</div>
 				<div class="m-row xsmallDisplay">
 					<div class="m-cell fullWidth">
 						<!-- ko if: order_item -->
 							<div data-bind="with: order_item">
 								<!-- ko if: order_item_id() || order.order_id() -->
 									<!-- ko if: $root.allowSave() -->
 										<button class="btnAction closeWindow" data-bind="click: function(data){$root.processModal(1, data, 'EditOrderItem')}">Save</button>
 									<!-- /ko -->
 									<!-- ko ifnot: $root.allowSave() -->
 										<button class="btnAction" disabled="disabled">Save</button>
 									<!-- /ko -->
 								<!-- /ko -->
 								<!-- ko if: !(order_item_id() || order.order_id()) -->
 									<!-- ko if: !$root.fromWaitList() -->
 										<!-- ko if: $root.allowSave() -->
 											<button class="btnAction closeWindow" data-bind="click: function(data){$root.processModal(1, data, 'add_order_item')}"> Add <!-- ko if: $root.next() --> & go to next item <!-- /ko -->
 											</button>
 										<!-- /ko -->
 										<!-- ko ifnot: $root.allowSave() -->
 											<button class="btnAction" disabled="disabled"> Add <!-- ko if: $root.next() --> & go to next item <!-- /ko -->
 											</button>
 										<!-- /ko -->
 									<!-- /ko -->
 									<!-- ko if: $root.fromWaitList() -->
 										<button class="btnAction closeWindow" data-bind="click: function(data){$root.processModal(1, data, 'register_from_waitlist')}">Add</button>
 									<!-- /ko -->
 								<!-- /ko -->
 								<button class="btnAction closeWindow" data-bind="click: function(data){$root.processModal(0, null, null)}">Cancel</button>
 							</div>
 						<!-- /ko -->
 						<!-- ko ifnot: order_item -->
 							<!-- ko if: $root.showViewCart() && !$root.addedFromGet() --> <a href="/registration/checkout/" target="_parent" class="btnAction">View Cart</a> <!-- /ko -->
 							<button class="btnAction closeWindow" data-bind="click: function(data){$root.processModal(0, null, null)}">Close</button>
 						<!-- /ko -->
 						<!-- ko if: order_item --> <a href="/users/add-child.php" target="_parent" class="btnAction">Add New Participant</a> <!-- /ko -->
 					</div>
 				</div>
 			</footer>
 		
 	</div>
   </script>
   <script id="priceInput" type="text/html">
    <div class="fieldStyle iconFieldContainer" data-bind="css: {rightIcon: (window._ACCOUNTING_SETTING.currency.format.pos.indexOf('%s') > window._ACCOUNTING_SETTING.currency.format.pos.indexOf('%v')) }">
 			<span class="indicator" data-bind="text: iconText, click: function(){isClickable() ? iconClick() : null;}"></span>
 			<input type="text" data-bind="value: formattedValue.localizedNumber(), enable: enable" class="textRight">
 			<input type="hidden" data-bind="value: unFormattedValue, attr: {name: inputName, id: inputId, class: inputClass}">
 		</div>
   </script>
   <script id="customLoadingTemp" type="text/html">
    <div id="customLoading" class="popContent">
 			<div class="popBody popBodyLoading">
 				<!-- ko if: image -->
 				
 					<img class="centerImg" data-bind="attr: {src: image}" alt="loading..">
 				
 				<!-- /ko -->
 				<!-- ko if: message -->
 				<p class="itemTitle textCenter" data-bind="text: message"></p>
 				<!-- /ko -->
 			</div>
 		</div>
   </script>
  </body>
 </html>